i11100001
111000111
001111111
111100011
001111111
111100111
010101101
01111111o