111111101110101010001110
111111110111110111011001
111011111101101111010011
100111111011011111111011
111i11111111110111111111
010001101001001111111110
110001111110010101111111
011101111011110111010110
111110111100110111101111
101101101000001110101111
111111100011101111101110
110100101111111010101011
001100110110100101011101
101110101110110111011101
101110110100101111101010
111111010111111111001011
110111111111111111101001
011111101011110111101100
101011111111101000001001
110111111010011111101111
111100111100100111110101
001111110101010111010o00
110011111011100111101011
