11111010111111101111100111111
11101001011011100101010110111
11010010101001111111101000110
11111101111100011110100100001
01i11101111111011011111011101
01111111100011010011111010101
01110101011111111011011111111
11111111011110011110101001000
11101001010111011111100101111
01101101110100111111011110110
00110010111111101110110011110
01000011101011111111011110111
00110110010111111111111101110
10111111111111111011111111111
01111100010001010111101100101
11011110101110111111101111101
10110111111111101011010111010
10011011001010101110001011011
11110111111011110111111111111
11110101100010011100110111011
11101101011111101111101110110
01101101101111111101110110101
01111101110111100110111101101
01110111110100101010100011011
11101101100111011110100111101
11011110111011100001010111011
11111011011110011110011o01100
11101110111011111101110110111
01011111111111111110100110111
01111011010110011000111110111
