11i110011101101111110
011111111000111011101
111110111110011111110
101100111111010111110
111111110110000111111
110011111111110111011
111110100110011110001
010111111011011011100
101010101011101001011
110110101100011001110
111110111100111111011
101000011110100110110
101011110011101001110
010110110110111111011
001001010110111110000
100110111111111101111
011100011111011011111
001111111110011010101
111011111101101111110
11011101000001111o101
110001011011110111101
111101111011101011101
011101000011110111001
010111111101011111111
010110101011111111011
111001111111111110001
