1111101000111010001010111101
1011111010101110001110110011
1101000011010101110010101110
0111101011111111101010111011
1111110110111011111110110110
1101101101010010101101111111
11101i0111111001000011111010
1111011101111111111111110101
1101010101111111111011101100
0011111111100110111011110010
1111011111011111111110111111
0100101111110101111111011111
1111110011111111011101111011
1110101001111110011101111100
1110101001111100010110111001
0010010010001111010100101101
1111110111010101101011101111
0111110011101111111000111110
1110010111011011011111101010
0111111101001111111010101110
1010111101111110110100001011
1111000011111111111111011011
0111100111101011111110101110
1110101111111111011100100101
1010011110110011101111111111
1111011011000111111101101100
1011011010111101010111011110
01100011111011110111111100o1
1011011011111101111101110100
