1010110101110111011110111
1010101110111110111111111
1001000101110101110101101
010i101110111000111111110
1011110111111111011101101
1011101010001111101111110
1111101101011011011111011
1101100011110011110011011
1110100101011111110110101
0100001111111011111100010
0101001110110111111010111
1111001111111000111111111
1111110010011011011111100
0101001111010101100110001
1110101111100110001110101
1111011111111101011101111
1000110110110011011011110
1011110111111111011011000
1111111111101011111111110
1101111111101111100101011
1011011111011111110011111
110010110111100101001o011
1011011100111010010011111
0010011001101111101011110
